B! PPP PPP PPP PPP *B
BP PWP PWP PWP PWP PB
BP PWP PWP PWP PWP PB
BP PWP PWP PWP PWP PB
BP PWP PWP PWP PWP PB
BP PWP PWP PWP PWP PB
BP PWP PWP PWP PWP PB
BP PWP PWP PWP PWP PB
BP PWP PWP PWP PWP PB
BPPPWPPPWPPPWPPPWPPPB
BBBBBBBBBBBBBBBBBBBBB