BWWWWWWWW B WWWWWWWWB
 PPPPPPPW B WPPPPPPP 
 P  BWWPW B WPWWB  P 
 PPPPPWPW B WPWPPPPP 
 B  BPWPW B WPWPB  B 
 PPPPPWPW B WPWPPPPP 
 P  BWWPW B WPWWB  P 
 PPPPPWPW B WPWPPPPP 
B   BPWPWWWWWPWPB   B
!PPPPPBPPPPPPPBPPPPP*
WWWWWWWB     BWWWWWWW