!  WW  B  BB   W*PPPP
P B W  BW PPP B  B BP
P  WW BWW PBPPPPP  PP
P WWBPPPPPPB   WP  PB
PWWPPPW BPPWWWWWPPWPP
PPWP   W PP  B  BPPPP
WPWP BPPPPPPPPPPPB   
WPPPPPP   W  B  P WWB
W   PB  WPPPB WBP WBW
  W P  BPP PPPP P WBW
    PPPPP   B PPPWWBW