        P!B*P        
       PPBWBPP       
      PPBWWWBPP      
     PPBWWWWWBPP     
    PPBWWBBBWWBPP    
   PPBWWBWBWBWWBPP   
  PPBWWWBWWWBWWWBPP  
 PPBWWWWWBBBWWWWWBPP 
PPBWWWWWWWWWWWWWWWBPP
PBBBBBBBBBBBBBBBBBBBP
PPPPPPPPPPPPPPPPPPPPP