*PPPPPPPPPPPPPPPPPPPP
WWWWWWWWWWWWWWWWWWWWP
WPPPPPPPPPPPPPPPPPPWP
WP               WPWP
WP PPPPPPPPPPPPPPWPWP
WP PBB          PWPWP
WP PB!PPPPPPPPPPPWPWP
WP PBBWWWWWWWWWWWWPWP
WP PPPPPPPPPPPPPPPPWP
WP WWWWWWWWWWWWWWWWWP
WPPPPPPPPPPPPPPPPPPPP