B* B!  BWWWWWWWWWWWBB
WPB PBBPPPPPPPPPPPPWB
WP BP  PB   WW  B PWB
WPB P  P BPPPPPP BPWB
WP BPBBPB PWWWWPB PWB
WPB P  P BPWBBWP BPWB
WP BPPPPB PWBBWPB PWB
WPB  WW  BPWBBWP BPWB
WP B WW B PWBBWPB PWB
WPPPPPPPPPPWBBWPPPPWB
BWWWWWWWWWWBBBBWWWWBB