BBBBBBBBBBBBBBBBBBBBB
BPPPPPPPPPPPPPPPPPPPB
BPW W W W W W W W WPB
BPWBBBWWBBBWWWBBBBWPB
BPWBWBWWBWWWWWBWWBWPB
BPWBBBWWBWWWWWBBBBWPB
BPWBWWWWBWWWWWBWWBWPB
BPWBWWBWBBBWBWBWWBWPB
BPPPPPPPPP PPPPPPPPPB
BBBBBBBBBP PBBBBBBBBB
BBBBBBBBB! *BBBBBBBBB